50 21 21 21 21 21 21 21 21 21 21 21 21 01 21 21 21 21 21 21 21 21 21 21 21 21 21 21 21 21 21 01 21 21 21 21 21 21 21 21 21 21 21 21 21 21 21 21 21 47
22 00 00 00 00 00 00 00 00 00 00 00 00 28 00 00 00 00 00 00 00 00 00 00 00 00 00 00 00 00 00 28 00 00 00 00 00 00 00 00 00 00 00 00 00 00 00 00 00 20
22 00 00 00 00 00 00 00 00 00 00 00 00 26 00 00 00 00 00 00 00 00 00 00 00 00 19 29 29 29 29 17 00 00 00 00 00 00 00 00 00 00 00 00 00 00 00 00 00 20
22 00 00 00 00 00 00 00 00 00 00 00 00 00 00 00 00 00 00 00 00 00 00 00 00 00 28 00 00 00 00 00 00 00 00 00 00 00 00 00 00 00 00 00 00 00 00 00 00 20
22 00 00 46 46 46 46 46 46 46 46 46 00 25 00 00 00 00 00 00 00 00 00 00 00 00 28 00 00 00 00 00 00 00 00 00 00 00 00 00 00 00 00 00 00 00 00 00 00 20
22 00 00 46 00 00 00 00 46 00 00 46 00 28 00 00 00 00 00 00 00 00 00 00 00 00 26 00 00 00 00 00 00 00 00 00 00 00 00 00 00 00 00 00 00 00 00 00 00 20
22 00 00 46 00 00 00 00 00 00 00 46 00 16 29 29 23 29 29 29 18 00 00 00 00 00 00 00 00 00 00 00 00 00 00 00 00 00 00 00 00 00 00 00 00 00 00 00 00 20
22 00 00 46 00 00 00 00 46 00 00 46 00 00 00 00 28 00 00 00 28 00 00 00 00 00 25 00 00 00 00 00 00 00 00 00 00 00 00 00 00 00 00 45 45 00 00 00 00 20
22 00 00 46 00 00 00 00 46 46 46 46 00 00 00 00 28 00 00 00 26 00 00 00 00 00 28 00 00 00 00 00 00 00 00 00 00 00 45 00 00 00 45 45 45 45 00 00 00 20
22 00 00 46 00 00 00 00 46 00 00 00 00 00 00 00 28 00 00 00 00 00 00 00 00 00 28 00 00 00 00 00 00 00 00 00 00 45 45 45 00 10 00 45 45 00 00 00 00 20
22 00 00 46 00 46 46 46 46 00 00 00 00 00 00 00 28 00 00 00 25 00 00 00 00 00 28 00 00 00 00 00 00 00 45 00 45 45 45 45 11 02 08 00 45 00 00 00 00 20
22 00 00 46 00 46 00 00 00 00 00 00 00 00 00 00 28 00 00 00 28 00 00 00 00 00 28 00 00 00 00 00 00 45 45 00 00 00 45 45 11 02 08 45 45 45 00 00 00 20
22 00 46 46 00 46 00 46 46 00 00 45 00 00 00 00 28 00 00 00 16 29 29 29 29 29 17 00 00 00 00 00 45 45 45 45 00 45 45 45 11 02 08 45 45 45 45 00 00 20
22 00 46 00 00 46 46 46 00 00 45 45 45 00 00 00 28 00 00 00 00 00 00 00 00 00 00 00 00 00 00 45 45 45 45 45 00 45 45 45 11 02 07 10 10 10 10 10 00 20
22 00 46 00 46 46 00 00 00 45 45 45 45 45 00 00 28 00 00 00 00 00 00 00 00 00 00 00 00 00 45 45 45 45 45 45 45 45 45 45 11 02 02 02 02 02 02 02 08 20
22 00 00 00 00 00 19 29 29 29 29 29 29 29 29 29 17 00 00 00 00 00 00 00 00 00 00 00 45 45 45 45 45 45 45 45 45 45 45 45 11 02 04 09 09 09 09 09 00 20
22 00 00 00 00 45 28 45 00 00 00 45 45 45 45 45 00 00 00 00 00 00 00 00 00 00 00 45 45 45 45 45 45 45 45 45 45 45 45 45 11 02 08 45 45 45 45 00 00 20
22 00 00 00 00 45 28 45 00 00 00 00 45 45 45 00 00 00 00 00 00 00 00 00 00 00 10 10 10 10 10 10 10 10 10 10 10 10 10 10 06 02 08 45 45 45 45 45 00 20
22 00 00 00 00 45 28 00 00 00 00 00 00 45 00 00 00 00 00 00 00 00 00 00 00 11 02 02 02 02 02 02 02 02 02 02 02 02 02 02 02 02 08 45 45 45 45 45 00 20
22 00 00 00 45 45 28 45 45 00 00 00 00 00 00 00 00 45 00 00 00 00 00 00 00 00 09 09 09 09 09 09 09 09 09 09 09 09 09 09 05 02 08 45 45 45 45 45 45 20
22 00 00 45 45 45 28 45 45 45 00 00 00 00 00 00 45 45 00 00 00 00 00 00 00 00 00 45 45 45 45 45 45 45 45 45 45 45 45 45 11 02 08 45 45 45 45 45 00 20
22 00 00 45 45 45 28 45 45 45 45 00 00 00 00 00 45 45 45 00 00 00 00 00 00 00 00 00 45 45 45 45 45 45 45 45 45 45 45 45 11 02 08 45 45 45 45 00 00 20
22 00 45 45 00 45 28 45 45 45 45 45 00 00 00 45 45 45 45 00 00 00 00 00 00 00 00 00 00 00 00 45 45 45 45 45 45 45 45 45 11 02 08 45 45 45 00 00 00 20
22 00 00 00 00 00 28 45 45 45 45 00 00 00 45 45 45 45 45 45 45 00 00 00 00 00 00 00 00 00 00 00 45 45 45 45 45 45 45 45 45 09 45 45 45 00 00 00 00 20
22 00 45 45 45 45 28 45 45 45 00 00 00 45 45 45 45 45 45 45 45 45 00 00 00 00 00 00 00 00 00 00 00 00 45 45 45 45 45 45 45 45 45 45 45 45 00 00 00 20
22 00 45 45 45 45 28 45 45 45 00 00 00 00 45 45 45 45 45 45 45 00 00 00 00 00 00 00 00 00 00 00 00 00 00 00 45 45 45 00 45 45 45 45 45 45 45 45 00 20
22 00 00 45 45 45 28 45 45 00 00 00 00 00 00 45 45 45 45 45 45 00 00 00 00 00 00 00 00 00 00 00 00 00 00 00 00 00 00 00 00 00 00 00 45 45 45 45 00 20
22 00 00 00 45 45 28 45 45 00 00 00 00 00 00 45 45 45 45 00 00 00 00 00 00 00 00 00 00 00 00 00 00 00 00 19 23 23 23 23 23 18 00 00 00 45 45 45 00 20
22 00 00 00 00 45 28 45 00 00 00 00 00 00 00 00 00 45 00 00 00 00 00 00 00 00 00 00 00 00 00 00 00 00 00 20 01 01 01 01 01 22 00 00 00 45 45 00 00 20
22 00 00 00 00 45 28 45 00 00 00 00 00 00 00 00 00 00 00 00 00 00 00 00 00 00 00 00 00 00 00 00 00 00 00 20 01 01 01 01 01 22 00 45 45 45 00 00 45 20
22 00 00 00 00 10 28 10 00 00 00 00 00 00 00 00 00 00 00 00 00 00 00 00 00 00 00 00 00 00 00 00 00 00 00 20 01 01 01 01 01 22 45 45 00 00 00 45 45 20
22 00 10 10 06 02 42 02 07 10 10 10 10 00 00 00 00 00 00 00 19 23 18 00 00 00 00 00 00 00 00 00 00 00 00 20 01 01 01 01 01 22 45 45 00 45 45 45 00 20
22 11 02 02 02 02 02 02 02 02 02 02 02 08 00 00 00 00 00 19 01 01 22 00 00 00 00 00 00 00 00 00 00 00 00 20 01 01 01 01 01 22 45 45 00 45 45 00 00 20
22 11 02 04 05 02 41 02 08 09 09 09 09 00 00 00 00 19 23 01 01 01 01 18 00 00 00 00 00 00 00 00 00 00 00 16 21 21 21 21 21 17 00 45 00 45 00 00 00 20
22 11 02 08 00 09 28 09 00 00 00 00 00 00 00 00 19 01 01 01 01 01 01 01 23 18 00 00 00 00 00 00 00 00 00 00 00 00 00 00 00 00 00 45 00 45 00 00 00 20
22 11 02 08 00 00 28 00 00 00 00 00 00 00 00 19 01 01 01 01 01 01 01 01 01 01 18 00 00 00 00 00 00 00 00 00 00 00 00 00 00 00 00 45 00 00 00 00 00 20
22 11 02 08 00 00 28 00 00 00 00 00 00 00 27 01 01 01 01 01 01 01 01 01 01 01 22 00 00 00 00 00 00 00 00 00 00 45 45 00 00 00 00 45 00 45 00 00 00 20
22 11 02 08 00 00 28 00 45 45 00 00 00 00 00 20 01 01 01 01 01 01 01 01 01 01 01 23 29 29 29 29 29 18 00 00 45 45 45 45 00 00 00 00 00 45 00 00 00 20
22 11 02 08 00 00 16 29 29 29 29 29 29 29 29 01 01 01 01 01 01 01 01 01 01 01 01 17 00 00 00 00 00 28 00 00 45 45 45 45 45 45 00 00 45 45 00 00 00 20
22 11 02 08 00 00 45 45 45 45 45 45 00 00 00 16 21 01 01 01 01 01 01 01 01 01 17 00 00 00 00 00 00 28 00 45 45 45 45 45 45 45 45 45 45 19 29 29 29 01
22 11 02 08 45 45 45 45 45 45 45 45 45 00 00 00 00 16 01 01 01 01 21 01 21 17 00 00 00 00 00 00 00 28 00 00 45 45 45 45 45 45 45 45 00 28 00 00 00 20
22 11 02 07 10 10 10 10 10 45 45 45 45 00 00 00 00 00 16 01 01 22 00 26 00 00 00 46 46 46 46 00 00 28 00 00 00 45 45 45 45 45 00 00 00 28 00 00 00 20
22 11 02 02 02 02 02 02 02 08 45 45 45 45 45 45 45 45 45 16 01 17 00 00 00 00 00 46 00 00 46 00 00 28 00 00 00 00 45 45 00 00 00 00 00 28 00 00 00 20
22 00 09 09 09 09 09 05 02 07 10 10 10 10 10 10 46 46 46 45 26 00 00 00 00 00 00 46 00 00 46 00 19 01 18 00 00 00 00 00 00 00 00 00 00 28 00 00 00 20
22 00 45 45 45 45 45 11 02 02 02 02 02 02 02 02 02 02 46 45 45 00 00 00 00 00 00 00 00 00 46 00 20 01 01 29 29 29 29 24 00 27 29 29 29 21 29 29 29 01
22 45 45 45 45 45 45 11 02 04 09 09 09 09 09 05 02 02 46 45 00 00 00 00 00 00 00 46 00 00 46 00 16 01 17 00 00 00 00 00 00 00 00 00 00 00 00 00 00 20
22 00 45 45 45 45 45 11 02 08 45 45 45 45 45 00 46 02 46 00 00 00 00 00 00 00 00 46 00 00 46 00 00 28 00 00 45 45 00 00 00 00 45 00 00 00 00 00 00 20
22 00 00 45 45 45 45 11 02 08 45 45 00 45 00 00 46 46 46 00 00 00 00 00 00 00 00 46 46 46 46 00 00 28 00 45 45 45 45 00 00 45 45 45 00 00 00 00 00 20
22 00 00 00 00 00 00 00 09 00 00 00 00 00 00 00 00 00 00 00 00 00 00 00 00 00 00 00 00 00 00 00 00 28 00 00 00 45 45 00 00 00 45 00 00 00 00 00 00 20
48 23 23 23 23 23 23 23 23 23 23 23 23 23 23 23 23 23 23 23 23 23 23 23 23 23 23 23 23 23 23 23 23 01 23 23 23 23 23 23 23 23 23 23 23 23 23 23 23 49